
NO ./aaaaaaaaaaaaaaaaaaaa
SO ./bbbbbbbbbbbbbbbbbbb

WE ./ccccccccccccccccc  

EA ./dddddddddddddddddddddddddddddddddddddd

F 77,95,22  

C   225   ,30 ,0  



1111
1001
1001
1S01
1001
1001
1001
1001
1001
1001
1N01
1111