NO ./aaaaaaaaaaaaaaaaaaaa
SO ./bbbbbbbbbbbbbbbbbbb

WE ./ccccccccccccccccc  

EA ./dddddddddddddddddddddddddddddddddddddd

F 77,95,22  

C   225   ,30 ,0  







11111111111111
1111001111111
11111111111111
1.......111111
1.......100001
1.......101101
1.......100101
11111111101101
10100000001101
101000N0001101
10100000001101
11100000001101
11110111111111
11110111111111
11000000110101
11111111111111
