NO ./aaaaaaaaaaaaaaaaaaaa
SO ./bbbbbbbbbbbbbbbbbbb

WE ./ccccccccccccccccc  

EA ./dddddddddddddddddddddddddddddddddddddd

F 77,95,22  

C   225   ,30 ,0  



........1111111111111111111111111
........1000000000110000000000001
........10110000011100000000000001
........100100000000000000000000001
111111111011000001110000000000000001
1000000000110000011101111111111000001
10000000001100000111011111111111111111
11110111111111011100000010001
11110111111111011101010010001
11000000110101011100000010001
10000000000001001100000010001
10000000000000001101010010001
11000001110101011111011110N0111
11110111.1110101.101111010001
11111111.1111111.111111111111


1111111111111111111111
1000000000000000000001
111111111111111111111111111111111111
