NO ./aaaaaaaaaaaaaaaaaaaa
SO ./bbbbbbbbbbbbbbbbbbb

WE ./ccccccccccccccccc  

EA ./dddddddddddddddddddddddddddddddddddddd

F 77,95,22  

C   225   ,30 ,0  







11111111111111111111111111111111111111
1N11100111111111111111111111111111111
11111111111111111111111111111111111111
........1111111111111111111111111111111
........100000000011000000000000111111
........101100000111000000000000011111
........100100000000000000000000001111
11111111101100000111000000000000000111
10100000001100000111011111111110000011
11100000001100000111011111111111111111
11110111111111011100000010001
11110111111111011101010010001
11000000110101011100000010001
10000000000001000000000010001
10000000000000001101010010001
110000011101010111111.10000111
11110111.1110101.101111010001
11111111.1111111.111111111111
1111111111111111111111
1000000000000000000001
1111111111111111111111111111111111111
